Allemand	=
Allemande	Allemand
Allemandes	Allemand
Allemands	Allemand
Américain	=
Américaine	Américain
Américaines	Américain
Américains	Américain
Anglais	=
Anglais	Anglais
Anglaise	Anglais
Anglaises	Anglais
Annamite	=
Annamite	Annamite
Annamites	Annamite
Annamites	Annamite
Antillais	=
Antillais	Antillais
Antillaise	Antillais
Antillaises	Antillais
Arménien	=
Arménienne	Arménien
Arméniennes	Arménien
Arméniens	Arménien
Australien	=
Australienne	Australien
Australiennes	Australien
Australiens	Australien
Autrichien	=
Autrichienne	Autrichien
Autrichiennes	Autrichien
Autrichiens	Autrichien
Auxerrois	=
Auxerrois	Auxerrois
Auxerroise	Auxerrois
Auxerroises	Auxerrois
Baoulé	=
Baoulé	Baoulé
Baoulé	Baoulé
Baoulé	Baoulé
Belge	=
Belge	Belge
Belges	Belge
Belges	Belge
Berlinois	=
Berlinois	Berlinois
Berlinoise	Berlinois
Berlinoises	Berlinois
Bolivien	=
Bolivienne	Bolivien
Boliviennes	Bolivien
Boliviens	Bolivien
Breton	=
Bretonne	Breton
Bretonnes	Breton
Bretons	Breton
Britannique	=
Britannique	Britannique
Britanniques	Britannique
Britanniques	Britannique
Brésilien	=
Brésilienne	Brésilien
Brésiliennes	Brésilien
Brésiliens	Brésilien
Canadien	=
Canadienne	Canadien
Canadiennes	Canadien
Canadiens	Canadien
Cantonais	=
Cantonais	Cantonais
Cantonaise	Cantonais
Cantonaises	Cantonais
Chilien	=
Chilienne	Chilien
Chiliennes	Chilien
Chiliens	Chilien
Chinois	=
Chinois	Chinois
Chinoise	Chinois
Chinoises	Chinois
Colombien	=
Colombienne	Colombien
Colombiennes	Colombien
Colombiens	Colombien
Costaricain	=
Costaricaine	Costaricain
Costaricaines	Costaricain
Costaricains	Costaricain
Costaricien	=
Costaricienne	Costaricien
Costariciennes	Costaricien
Costariciens	Costaricien
Crétois	=
Crétois	Crétois
Crétoise	Crétois
Crétoises	Crétois
Cubain	=
Cubaine	Cubain
Cubaines	Cubain
Cubains	Cubain
Danois	=
Espagnol	=
Espagnole	Espagnol
Espagnoles	Espagnol
Espagnols	Espagnol
Européen	=
Européenne	Européen
Européennes	Européen
Européens	Européen
Finlandais	=
Finlandais	Finlandais
Finlandaise	Finlandais
Finlandaises	Finlandais
Français	=
Français	Français
Française	Français
Françaises	Français
Grec	=
Grecque	Grec
Grecques	Grec
Grecs	Grec
Guatémaltèque	=
Guatémaltèque	Guatémaltèque
Guatémaltèques	Guatémaltèque
Guatémaltèques	Guatémaltèque
Haïtien	=
Haïtienne	Haïtien
Haïtiennes	Haïtien
Haïtiens	Haïtien
Hondurien	=
Hondurienne	Hondurien
Honduriennes	Hondurien
Honduriens	Hondurien
Hongrois	=
Hongrois	Hongrois
Hongroise	Hongrois
Hongroises	Hongrois
Hun	=
Hun	Hun
Huns	Hun
Huns	Hun
Indien	=
Indienne	Indien
Indiennes	Indien
Indiens	Indien
Indonésien	=
Indonésienne	Indonésien
Indonésiennes	Indonésien
Indonésiens	Indonésien
Iranien	=
Iranienne	Iranien
Iraniennes	Iranien
Iraniens	Iranien
Irlandais	=
Irlandais	Irlandais
Irlandaise	Irlandais
Irlandaises	Irlandais
Israélien	=
Israélienne	Israélien
Israéliennes	Israélien
Israéliens	Israélien
Italien	=
Italienne	Italien
Italiennes	Italien
Italiens	Italien
Japonais	=
Japonais	Japonais
Japonaise	Japonais
Japonaises	Japonais
Jordanien	=
Jordanienne	Jordanien
Jordaniennes	Jordanien
Jordaniens	Jordanien
Kabyle	=
Kabyle	Kabyle
Kabyles	Kabyle
Kabyles	Kabyle
Khmer	=
Khmers	Khmer
Khmère	Khmer
Khmères	Khmer
Laotien	=
Laotienne	Laotien
Laotiennes	Laotien
Laotiens	Laotien
Libanais	=
Libanais	Libanais
Libanaise	Libanais
Libanaises	Libanais
Libyen	=
Libyenne	Libyen
Libyennes	Libyen
Libyens	Libyen
Libérien	=
Libérienne	Libérien
Libériennes	Libérien
Libériens	Libérien
Malgache	=
Malgache	Malgache
Malgaches	Malgache
Malgaches	Malgache
Maltais	=
Maltais	Maltais
Maltaise	Maltais
Maltaises	Maltais
Marocain	=
Marocaine	Marocain
Marocaines	Marocain
Marocains	Marocain
Mauritanien	=
Mauritanienne	Mauritanien
Mauritaniennes	Mauritanien
Mauritaniens	Mauritanien
Mexicain	=
Mexicaine	Mexicain
Mexicaines	Mexicain
Mexicains	Mexicain
Norvégien	=
Norvégienne	Norvégien
Norvégiennes	Norvégien
Norvégiens	Norvégien
Néerlandais	=
Néerlandais	Néerlandais
Néerlandaise	Néerlandais
Néerlandaises	Néerlandais
Néo-zélandais	=
Néo-zélandais	Néo-zélandais
Néo-zélandaise	Néo-zélandais
Néo-zélandaises	Néo-zélandais
Palestinien	=
Palestinienne	Palestinien
Palestiniennes	Palestinien
Palestiniens	Palestinien
Polynésien	=
Polynésienne	Polynésien
Polynésiennes	Polynésien
Polynésiens	Polynésien
Péruvien	=
Péruvienne	Péruvien
Péruviennes	Péruvien
Péruviens	Péruvien
Québecois	=
Québecois	Québecois
Québecoise	Québecois
Québecoises	Québecois
Salvadorien	=
Salvadorienne	Salvadorien
Salvadoriennes	Salvadorien
Salvadoriens	Salvadorien
Savoyard	=
Savoyarde	Savoyard
Savoyardes	Savoyard
Savoyards	Savoyard
Siamois	=
Siamois	Siamois
Siamoise	Siamois
Siamoises	Siamois
Soudanais	=
Soudanais	Soudanais
Soudanaise	Soudanais
Soudanaises	Soudanais
Sri_Lankais	=
Sri_Lankais	Sri_Lankais
Sri_Lankaise	Sri_Lankais
Sri_Lankaises	Sri_Lankais
Suisse	=
Suisse	Suisse
Suisses	Suisse
Suisses	Suisse
Suissesse	Suisse
Suissesses	Suisse
Sénégalais	=
Sénégalais	Sénégalais
Sénégalaise	Sénégalais
Sénégalaises	Sénégalais
Tunisien	=
Tunisienne	Tunisien
Tunisiennes	Tunisien
Tunisiens	Tunisien
Turc	=
Turcs	Turc
Turque	Turc
Turques	Turc
Tzigane	=
Tzigane	Tzigane
Tziganes	Tzigane
Tziganes	Tzigane
Yéménite	=
Yéménite	Yéménite
Yéménites	Yéménite
Yéménites	Yéménite
Équatorien	=
Équatorienne	Équatorien
Équatoriennes	Équatorien
Équatoriens	Équatorien
