abandon	abandonment
abase	abasement
abate	abatement
abbreviate	abbreviation
abdicate	abdication
abduct	abduction
abductor	abduction
abhor	abhorrence
abjure	abjuration
abolish	abolition
abolishment	abolition
abominate	abomination
abort	abortion
abrade	abrasion
abrasive	abrasion
abridge	abridgement
abrogate	abrogation
absent	absent
absorb	absorption
absorbent	absorption
absorber	absorption
abstain	abstention
abstainer	abstention
abuse	abuse
abut	abutment
accelerate	acceleration
accelerator	acceleration
accentuate	accentuation
accept	acceptation
acceptance	acceptation
acclimate	acclimation
acclimatize	acclimatization
accommodate	accommodation
accompanist	accompaniment
accompany	accompaniment
accomplish	accomplishment
account	account
accountability	account
accredit	accreditation
accrete	accretion
accrue	accrual
accumulate	accumulation
accumulator	accumulation
accuse	accusation
accuser	accusation
achieve	achievement
acknowledge	acknowledgment
acknowledgement	acknowledgment
acquaint	acquaintance
acquiesce	acquiescence
acquire	acquisition
acquirement	acquisition
acquirer	acquisition
acquit	acquittal
act	act
activate	activation
actor	act
adapt	adaptation
adapter	adaptation
adapting	adaptation
adaptor	adaptation
add	addition
addict	addict
address	address
addressee2	address
adhere	adhesion
adherence	adhesion
adherent	adhesion
adhesive	adhesion
adjoin	junction
adjourn	adjournment
adjudicate	adjudication
adjudicator	adjudication
adjure	adjuration
adjust	adjustment
adjuster	adjustment
administer	administration
administrate	administrate
admire	admiration
admirer	admiration
admit	admittance
admission	admittance
admonish	admonition
adopt	adoption
adore	adoration
adorer	adoration
adorn	adornment
adulterant	adulteration
adulterate	adulteration
advance	advance
adventure	adventure
advertise	advertisement
advertisement	ad
advertiser	advertisement
advertising	advertisement
advise	advice
adviser	advice
advisor	advice
advocate	advocacy
advocate	advocacy
aerate	aeration
affiliate	affiliate
affirm	affirmation
afflict	affliction
afford	afford
afforest	afforestation
affront	effrontery
age	age
agglomerate	agglomeration
aggrandize	aggrandizement
aggravate	aggravation
agitate	agitation
agitator	agitation
agree	agreement
agress	aggression
ail	ail
air	air
alarm	alarm
alienate	alienation
align	alignment
allege	allegation
alleviate	alleviation
allocate	allocation
allocator	allocation
allot	allotment
allow	allowance
allude	allusion
ally	alliance
ally	alliance
alter	alteration
alternate	alternation
amalgamate	amalgamation
amaze	amazement
ameliorate	amelioration
amend	amendment
amortize	amortization
amplifier	amplification
amplify	amplification
amputate	amputation
amuse	amusement
anaesthetize	anaesthetize
analyst	analysis
analyze	analysis
analyzer	analysis
anesthetize	anesthetize
angle	angle
animadvert	animadversion
animate	animation
annihilate	annihilation
annotate	annotation
announce	announcement
announcer	announcement
annoy	annoyance
annul	annulment
annunciate	annunciation
anoint	anointment
antagonist	antagonism
antagonize	antagonism
anticipate	anticipation
apologist	apology
apologize	apology
appear	appearance
apparition	appearance
appease	appeasement
applaud	applause
applicability	application
applicant	application
apply	application
appliance	application
appoint	appointment
appointee	appointment
apportion	apportionment
appraise	appraisal
appraiser	appraisal
appreciate	appreciation
apprehend	apprehension
appropriate	appropriation
appropriator	appropriation
approve	approval
approbation	approval
approving	approval
approximate	approximation
arbitrate	arbitration
arbitrator	arbitration
argue	argument
arm	arm
arraign	arraignment
arrange	arrangement1
arrangement2	arrangement1
arrest	arrest
arrive	arrival
articulate	articulation
ascend	ascent
ascension	ascent
ascendency	ascent
accession	ascent
ascendant	ascent
ascendent	ascent
ascribe	ascription
ask	ask
asperse	aspersion
asphyxiate	asphyxiation
aspirant	aspiration2
aspirate	aspiration2
aspire	aspiration1
assail	assail
assassinate	assassination
assemble	assembly
assemblage	assembly
assert	assertion
assess	assessment
assessor	assessment
asseverate	asseveration
assign	assignment
assignation	assignment
assimilate	assimilation
assist	assistance
assistant	assistance
associate	associate
assume	assumption
assure	assurance
astonish	astonishment
atomize	atomize
atone	atonement
attach	attachment
attack	attack
attain	attainment
attend	attention
attendance	attention
attendant	attention
attendee	attention
attenuate	attenuation
attract	attraction
auction	auction
auctioneer	auction
audit	audit
augment	augmentation
augur	augury
authenticate	authentication
authority	authorization
authorize	authorization
automate	automation
avenge	avenge
average	average
avert	aversion
avoid	avoidance
avow	avowal
award	award
babble	babble
babysit	babysit
back	back
back-up	back
backbite	backbite
backer	back
bag	bag
bagger	bag
bail	bail
bail	bail
bailor	bail
bake	bake
balance	balance
balloon	balloon
ballot	ballot
ban	ban
banish	banishment
bank	banking
banker	banking
banner	ban
baptize	baptism
bar	bar
barbarize	barbarism
bargain	bargain
bark	bark
barnstorm	barnstorm
barter	barter
barterer	barter
bash	bash
bat	batting
bathe	bathe
batter	batter
batter	batter
battle	battle
be	being
beam	beam
bear	birth
bearing	birth
bearer	birth
beat	beat
beatify	beatification
bedevil	bedevilment
beep	beep
beg	beggary
beget	beget
beggar	beggary
begin	begin
beginner	begin
behave	behavior
behead	behead
behold	behold
believe	belief
believer	belief
bend	bend
benefactor	benefit
benefit	benefit
bequeath	bequest
bereave	bereavement
berth	berth
besiege	seige
besieger	seige
bestow	bestowal
bet	bet
betray	betrayal
betrayer	betrayal
betroth	betrothal
bettor	bet
bewilder	bewilderment
bicker	bicker
bid	bid
bifurcate	bifurcation
bind	bind
bisect	bisection
blacklist	blacklist
blackmail	blackmail
blaspheme	blaspheme
blaze	blaze
blazon	blazonry
bleach	bleach
bleed	bleed
blemish	blemish
bless	bless
blight	blight
block	block
bloom	bloom
blot	blot
blow	blow
bluff	bluff
blunder	blunder
board	board
boast	boast
boat	boat
boil	boil
bomb	bomb
bombard	bombardment
bomber	bomb
boost	boost
bootleg	bootleg
booze	booze
border	border
bore	boredom
borer	boredom
borrow	borrowing
borrower	borrowing
botch	botch
bottle	bottle
bottler	bottle
bound	bound
bowl	bowl
box	box
brainstorm	brainstorm
brave	bravery
brawl	brawl
break	break
break-up	break
breakdown	break
breaker	break
breakup	break
breathe	breathing
breather	breathing
breed	breed
brew	brew
brewer	brew
bridge	bridge
brighten	brighten
bring	bring
broadcast	broadcast
broadcaster	broadcast
broil	broil
broker	broker
broker	broker
bruise	bruise
buff	buff
bug	bug
bugger	bug
build	build
build-up	build
builder	build
buildup	build
bulldoze	bulldoze
bump	bump
bungle	bungle
burgle	burglary
burn	burn
burner	burn
bury	burial
bust	bust
butcher	butchery
buy	buy
buy-back	buy
buy-out	buy
buyer	buy
buzz	buzz
cackle	cackle
cadge	cadge
cage	cage
cajole	cajolery
calcine	calcination
calculate	calculation
calculator	calculation
calibrate	calibration
call	call
caller	call
camp	camp
campaign	campaign
can	can
canalize	canalization
cancel	cancellation
canceling	cancellation
cannibalize	cannibalism
canoe	canoe
canonize	canonization
cant	cant
canter	cant
capitalist	capitalization
capitalize	capitalization
capitulate	capitulation
caption	caption
captive	capture
captor	capture
capture	capture
carbonize	carbonization
caricature	caricature
carol	carol
carouse	carousal
carp	carp
carpet	carpet
carrier	carry
carry	carry
carry-forward	carry
carryover	carry
cart	cart
cartoon	cartoon
carve	carve
carver	carve
cast	cast
caster	cast
castigate	castigation
castrate	castration
catalyst	catalysis
catalyze	catalysis
catch	catch
catechize	catechism
cater	cater
caterer	cater
cause	causation
cause	causation
cave	cave
cease	cessation
cede	cession
celebrant	celebration
celebrate	celebration
censer	censure
censure	censure
centralize	centralization
certify	certification
chair	chair
challenge	challenge
champ	champion
champion	champion
change	change
changeover	change
characterize	characterization
charge	charge
charge-off	charge
charger	charge
charm	charm
chart	chart
chase	chase
chastise	chastisement
cheat	cheat
cheater	cheat
check	check
chisel	chisel
chiseler	chisel
chlorinate	chlorination
choke	choke
choose	choice
choosing	choice
chop	chop
chronicle	chronicle
circulate	circulation
circumcise	circumcision
circumnavigate	circumnavigation
circumscribe	circumscription
circumvent	circumvention
cite	citation
civilize	civilization
claim	claim
clamp	clamp
clang	clang
clanger	clang
clangor	clang
clap	clap
clarify	clarification
classify	classification
clean	clean
cleaner	clean
cleanse	cleanse
clear	preclearance
clearance	preclearance
clearing	preclearance
cleave	cleave
clerk	clerk
climb	climb
climber	climb
clinch	clinch
clink	clink
clip	clip
clog	clog
close	close
cloud	cloud
co-operate	co-operation
co-opt	co-optation
coach	coach
coagulate	coagulation
coalesce	coalescence
cobble	cobble
code	code
codify	codification
coerce	coercion
coexist	coexistence
cogenerate	cogeneration
cogitate	cogitation
cohabit	cohabitation
cohere	cohesion
coherence	cohesion
coin	coinage
coincide	coincidence
coiner	coinage
collaborate	collaboration
collaborator	collaboration
collar	collar
collate	collation
collect	collection
collectability	collection
collecting	collection
collectivize	collectivization
collector	collection
collide	collision
collocate	collocation
collude	collusion
colonialist	colonization
colonist	colonization
colonize	colonization
colonizer	colonization
combat	combat
combine	combination
combust	combustion
come	come
comeback	come
comer	come
comfort	comfort
command	command
commemorate	commemoration
commence	commencement
commend	commendation
commentate	commentate
commercialize	commercialization
commiserate	commiseration
commission	commission
commission	commission
commissioner	commission
commit	commitment
commital	commitment
commission	commitment
commune	communion
communicant	communication
communicate	communication
commute	commutation
commuter	commutation
comparability	comparison
compare	comparison
compensate	compensation
compete	competitiveness
competition	competitiveness
competitor	competitiveness
compile	compilation
compiler	compilation
complain	complaint
complainant	complaint
complete	completion
complicate	complication
comply	compliance
complaisance	compliance
comport	comportment
compose	composure
composition	composure
composer	composure
compound	compound
comprehend	comprehension
compress	compression
compressor	compression
compute	computation
computer	computation
computing	computation
conceal	concealment
concede	concession
conceive	conception
concept	conception
conceiver	conception
conceptualize	conceptualization
conciliate	conciliation
conclude	conclusion
concoct	concoction
concur	concurrence
concuss	concussion
condemn	condemnation
condense	condensation
condenser	condensation
condescend	condescension
condition	condition
condone	condonation
conduct	conduct
confabulate	confabulation
confederate	confederation
confer	conferment
conference	conferment
conferee	conferment
confess	confession
confessor	confession
confidant	confidence
confide	confidence
configure	configuration
confirm	confirmation
confiscate	confiscation
conflate	conflation
conform	conformation
conformist	conformation
confront	confrontation
confuse	confusion
confute	confutation
congratulate	congratulation
congregate	congregation
conjoin	conjunction
conjugate	conjugation
conjure	conjuration
conjurer	conjuration
conjuror	conjuration
connect	connection
connector	connection
connive	connivance
connote	connotation
conquer	conquest
conqueror	conquest
conscript	conscription
consecrate	consecration
conserve	conservation
conservancy	conservation
consider	consideration
consign	consignment
consignee	consignment
consigner	consignment
consigning	consignment
consignor	consignment
consist	consistence
console	consolation
consolidate	consolidation
conspirator	conspiracy
conspire	conspiracy
constipate	constipation
constitute	constitution
constrain	constraint
constrict	constriction
construct	construction
constructing	construction
constructor	construction
consult	consultation
consultant	consultation
consulting	consultation
consume	consumption
consumer	consumption
consuming	consumption
consummate	consummation
contain	containment
container	containment
contaminant	contamination
contaminate	contamination
contemplate	contemplation
contend	contention
contender	contention
content	containment
contest	contest
continue	continuation
continuance	continuation
contort	contortion
contract	contract
contractor	contract
contradict	contradiction
contravene	contravention
contribute	contribution
contributor	contribution
contrive	contrivance
contriver	contrivance
control	control
controller	control
contuse	contusion
convalesce	convalescence
convalescent	convalescence
convene	convention
convener	convention
converge	convergence
converse	conversation
convert	conversion
convert	conversion
converter	conversion
convertibility	conversion
convey	conveyance
conveyer	conveyance
conveyor	conveyance
convict	conviction
convoke	convocation
convulse	convulsion
cook	cook
cook	cook
cool	cool
coolant	cool
cooler	cool
cooperate	cooperative
cooperation	cooperative
cooperator	cooperative
coordinate	coordination
coordinator	coordination
copier	copy
copulate	copulation
copy	copy
copy	copy
copyist	copy
cork	cork
correct	correction
correlate	correlation
correspond	correspondence
correspondent	correspondence
corroborate	corroboration
corrode	corrosion
corrugate	corrugation
corrupt	corruption
counsel	counsel
counsellor	counsel
count	count
countdown	count
counter	count
counteract	counteraction
counterfeit	counterfeit
countertrade	countertrade
couple	couple
course	course
court	courtship
crack	crack
crackdown	crack
cram	cram
crave	craving
crawl	crawl
create	creation
creator	creation
credit	credential
crediting	credential
creditor	credential
creep	creep
cremate	cremation
crier	cry
critic	criticism
criticize	criticism
croon	croon
crop	crop
cross-examine	cross-examination
cross-examiner	cross-examination
cross-fertilize	cross-fertilization
cruise	cruise
crusade	crusade
crush	crush
cry	cry
crystallize	crystallization
culminate	culminate
cultivate	cultivation
cultivator	cultivation
cure	cure
curl	curl
curtail	curtailment
cut	cut
cutback	cut
cutoff	cut
cutout	cut
dabble	dabble
dally	dalliance
dam	dam
damn	damnation
dampen	dampen
dance	dance
daub	daub
dawdle	dawdle
dawn	dawn
de-emphasize	de-emphasis
de-escalate	de-escalation
deactivate	inactivation
deal	deal
dealer	deal
debark	debarkation
debase	debasement
debate	debate
debauch	debauchery
debauchee	debauchery
decant	decant
decapitate	decapitation
deceive	deception
deceiver	deception
decentralize	decentralization
decide	decision
decimalize	decimalization
declare	declaration
declassify	declassification
decline	declination
decliner	declination
decode	decode
decolonize	decolonization
decompose	decomposition
decompress	decompression
decontaminate	decontamination
decorate	decoration
decorator	decoration
dedicate	dedication
deduce	deduction2
deduct	deduction1
deductibility	deduction1
deepen	deepen
deface	defacement
defame	defamation
default	default
defecate	defecation
defect	defect
defend	defense
defendant	defense
defender	defense
defer	deferral
deferment	deferral
deference	deferral
defile	defilement
define	definition
deflate	deflation
deflator	deflation
deflect	deflection
defoliant	defoliation
defoliate	defoliation
defray	defrayment
defrayal	defrayment
defrost	defrost
defy	defiance
degenerate	degeneration
degrade	degradation
deify	deification
delete	deletion
deliberate	deliberation
delimit	delimitation
delineate	delineation
deliver	delivery
deliverance	delivery
deliverer	delivery
delude	delusion
delve	delve
demagnetize	demagnetization
demarcate	demarcation
demean	demeanor
demobilize	demobilization
democratize	democratization
demolish	demolition
demonetize	demonetization
demonstrate	demonstration
demo	demonstration
demonstrator	demonstration
demoralize	demoralization
demote	demotion
denationalize	denationalization
denier	denial
denigrate	denigration
denominate	denomination
denominator	denomination
denounce	denunciation
denude	denudation
deny	denial
depart	departure
depend	dependency
dependence	dependency
dependant	dependency
dependent	dependency
depict	depiction
deplete	depletion
deploy	deployment
depopulate	depopulation
deport	deportment
deportation	deportment
deportee	deportment
depose	deposition
deposit	deposit
deprecate	deprecation
depreciate	depreciation
depress	depression
depressant	depression
deprive	deprivation
depute	deputation
derail	derailment
derange	derangement
deregulate	deregulaton
deregulation	deregulaton
deride	derision
derive	derivative
derivation	derivative
derogate	derogation
desalinate	desalination
desalinize	desalinization
descend	descent
descendant	descent
describe	description
desecrate	desecration
desegregate	desegregation
desensitize	desensitization
desert	desertion
deserter	desertion
desiccate	desiccate
design	design
designate	designation
designee	designation
designer	design
desolate	desolation
despair	desperation
destine	destiny
destination	destiny
destroy	destruction
destroyer	destruction
detach	detachment
detain	detention
detainee	detention
detect	detection
detective	detection
detector	detection
deter	deterrence
deteriorate	deterioration
determinant	determination
determine	determination
determiner	determination
deterrent	deterrence
detest	detestation
dethrone	dethronement
detonate	detonation
detonator	detonation
detoxify	detoxification
detract	detraction
detractor	detraction
detribalize	detribalization
devaluate	devaluation
devastate	devastation
develop	development
developer	development
developing	development
deviant	deviation
deviate	deviation
devise	devise
devitalize	devitalization
devote	devotion
devotee	devotion
diagnose	diagnosis
dicker	dicker
dictate	dictate
die	death
differ	differential
difference	differential
differentiate	differentiation
diffract	diffraction
diffuse	diffusion
dig	dig
digest	digestion
digger	dig
digress	digression
dilate	dilation
dilute	dilution
dime	dime
diminish	diminution
dine	dine
dip	dip
direct	directive
direction	directive
director	directive
disable	disablement
disagree	disagreement
disappear	disappearance
disappoint	disappointment
disapprove	disapproval
disapprobation	disapproval
disarm	disarmament
disarmament	disarmament
disarming	disarmament
disarrange	disarrangement
disavow	disavowal
disband	disbandment
disbanding	disbandment
disbelieve	disbelief
disburse	disbursement
discern	discernment
disclaim	disclaim
disclose	disclosure
discolor	discoloration
discolour	discolouration
discombobulate	discombobulation
discomfit	discomfort
discomfiture	discomfort
discompose	discomposure
discontinue	discontinuation
discontinuance	discontinuation
discount	discount
discounter	discount
discourage	discouragement
discover	discovery
discoverer	discovery
discredit	discredit
discriminate	discrimination
discuss	discussion
disembark	disembarkation
disembarrass	disembarrassment
disenchant	disenchantment
disengage	disengagement
disentangle	disentanglement
disestablish	disestablishment
disfigure	disfigurement
disfranchise	disfranchisement
disgorge	disgorgement
disincline	disinclination
disinfect	disinfection
disinfectant	disinfection
disinfest	disinfestation
disinherit	disinheritance
disintegrate	disintegration
disinter	disinterment
dislocate	dislocation
dislodge	dislodgement
dismantle	dismantlement
dismember	dismemberment
dismiss	dismissal
disobey	disobedience
disorganize	disorganization
disparage	disparagement
dispatch	dispatch
dispensary	dispensation
dispense	dispensation
dispenser	dispensation
disperse	dispersion
dispersal	dispersion
displace	displacement
displacing	displacement
displease	displeasure
disposable	disposition
dispose	disposition
disposal	disposition
dispossess	dispossession
disputant	disputation
dispute	disputation
disqualify	disqualification
disrupt	disruption
dissatisfy	dissatisfaction
dissect	dissection
dissemble	dissemble
disseminate	dissemination
dissent	dissension
dissenter	dissension
dissimulate	dissimulation
dissipate	dissipation
dissociate	dissociation
dissolve	dissolution
dissuade	dissuasion
distend	distension
distill	distillation
distiller	distillation
distinguish	distinction
distort	distortion
distract	distraction
distribute	distribution
distributer	distribution
distributor	distribution
distributorship	distribution
district	district
disturb	disturbance
divagate	divagation
dive	dive
dive-bomb	dive-bomb
diverge	divergence
diversify	diversification
divert	diversion
divest	divestment
divestiture	divestment
divide	divide
divine	divination
diviner	divination
divorce	divorce
divulge	divulgence
do	wrongdoing
deed	wrongdoing
do-gooder	wrongdoing
dock	dock
docker	dock
dodder	dodder
dodge	dodge
doer	wrongdoing
domesticate	domestication
dominate	dominion
domination	dominion
dominance	dominion
donate	donation
donor	donation
double	double
dower	dower
dower	dower
downfall	fall
downgrade	downgrade
downsize	downsizing
dowse	dowse
draft	draft
draftee1	draft
draftee2	draft
drag	drag
dramatist	dramatization
dramatize	dramatization
drape	drape
dream	dream
dredge	dredge
drench	drenching
dress	dress
dresser	dress
dribble	dribble
drift	drift
drill	drill
drink	drink
drive	drive
drivel	drivel
driver	drive
drop	drop
drop-off	drop
dropout	drop
drub	drubbing
drudge	drudgery
drum	drum
dry	dry
dry-clean	dry-clean
duel	duel
duelist	duel
duellist	duel
dump	dump
duplicate	duplication
duplicator	duplication
dust	dust
dwell	dwelling
dweller	dwelling
dye	dye
dyer	dye
earn	earn
earner	earn
ease	ease
eat	eat
eavesdrop	eavesdrop
eavesdropper	eavesdrop
edify	edification
edit	edition
editor	edition
educate	eduction
education	eduction
educator	eduction
efface	effacement
effervesce	effervescence
ejaculate	ejaculation
eject	ejection
ejector	ejection
elaborate	elaboration
elate	elation
elect	election
elector	election
electorate	election
electrify	electrolysis
electrification	electrolysis
electrocute	electrocution
elevate	elevation
elevator	elevation
elicit	elicitation
elide	elision
eliminate	elimination
elongate	elongation
elope	elopement
elucidate	elucidation
emaciate	emaciation
emanate	emanation
emancipate	emancipation
emasculate	emasculation
embalm	embalmment
embark	embarkation
embarrass	embarrassment
embellish	embellishment
embezzle	embezzlement
embitter	embitterment
embody	embodiment
embroider	embroidery
emend	emendation
emerge	emergence
emigrant	emigration
emigrate	emigration
emit	emission
emphasize	emphasis
employ	employment
employee	employment
employer	employment
emulate	emulation
enact	enactment
encamp	encampment
enchant	enchantment
enchanter	enchantment
encircle	encirclement
enclose	enclosure
encourage	encouragement
encroach	encroachment
endanger	endangerment
endear	endearment
endorse	endorsement
endow	endowment
endure	endurance
enforce	enforcement
enforcer	enforcement
enfranchise	enfranchisement
engage	engagement
engineer	engineer
engorge	engorgement
engrave	engrave
enhance	enhancement
enjoy	enjoyment
enlarge	enlargement
enlighten	enlightenment
enlist	enlistment
ennoble	ennoblement
enquire	enquiry
enquirer	enquiry
enrich	enrichment
enroll	enrolment
enrollment	enrolment
enrollee	enrolment
enslave	slavery
enslavement	slavery
entangle	entanglement
enter	entry
entrance	entry
entertain	entertainment
entertainer	entertainment
enthrone	enthronement
entice	enticement
entitle	entitlement
entrant	entry
entreat	entreaty
entrench	entrenchment
entrust	entrust
enumerate	enumeration
enunciate	enunciation
envelope	envelopment
equal	equal
equalize	equalization
equalizer	equalization
equate	equation
equip	equipment
eradicate	eradication
erase	erasure
eraser	erasure
erect	erection
erode	erosion
err	error
erupt	eruption
escalate	escalation
escalator	escalation
escape	escape
escort	escort
espouse	espousal
establish	establishment
establishing	establishment
estimate	estimate
estrange	estrangement
etch	etch
eulogize	eulogize
evacuate	evacuation
evacuee	evacuation
evade	evasion
evader	evasion
evaluate	evaluation
evaporate	evaporation
evict	eviction
evidence	evidence
evolve	evolution
exacerbate	exacerbation
exact	exaction
exaggerate	exaggeration
exalt	exaltation
examine	examination
examiner	examination
example	exemplification
exasperate	exasperation
excavate	excavation
excavator	excavation
exceed	excess
excel	excellence
except	exception
exchange	exchange
exchanger	exchange
excise	excision
excite	excitement
exclaim	exclamation
exclude	exclusion
excogitate	excogitation
excommunicate	excommunication
excoriate	excoriation
excrete	excretion
execrate	execration
executant	execution
execute	execution
executor	execution
exemplify	exemplification
exempt	exemption
exercise	exercise
exert	exertion
exhale	exhalation
exhaust	exhaustion
exhibit	exhibit
exhilarate	exhilaration
exhort	exhortation
exhume	exhumation
exist	existence
existing	existence
exonerate	exoneration
exorcise	exorcism
expand	expansionism
expansion	expansionism
expanding	expansionism
expect	expectation
expectancy	expectation
expedite	expedition
expel	expulsion
explusion	expulsion
expend	expense
experiment	experiment
expiate	expiation
expire	expiry
expiration	expiry
explain	explanation
explode	explosion
explore	exploration
explorer	exploration
export	export
expose	exposure
exposition	exposure
expostulate	expostulation
express	expression
expropriate	expropriation
expurgate	expurgation
extend	extension
extent	extension
extenuate	extenuation
exterminate	extermination
extinguish	extinguish
extirpate	extirpation
extort	extortion
extradite	extradition
extrapolate	extrapolation
extricate	extrication
extrude	extrusion
exult	exultation
fabricate	fabrication
fabricator	fabrication
face	face
factor	factor
fail	failure
faint	faint
fall	fall
falsify	falsification
familiarize	familiarization
fancy	fancy
farm	farm
farmer	farm
fascinate	fascination
fasten	fasten
favor	favor
federate	federation
feed	feed
feeder	feed
feel	feel
felicitate	felicitation
fence	fence
fend	fend
ferment	fermentation
fertilize	fertilization
fertilizer	fertilization
fib	fib
fiddle	fiddle
fiddler	fiddle
field	field
fight	fight
file	file
filers	file
fill	filling
filter	filter
finance	finance
financer	finance
financier	finance
find	find
finder	find
firefight	firefight
firm	firm
fish	fishing
fisher	fishing
fisherman	fishing
fit	fit
fixate	fixation
flagellant	flagellation
flagellate	flagellation
flap	flap
flatter	flattery
flatterer	flattery
flaw	flaw
flick	flick
flier	flight
flip	flip
flirt	flirtation
float	flotation
floatation	flotation
flood	flood
flow	flow
fluctuate	fluctuation
fluoridate	fluoridation
fluoridize	fluoridization
flute	fluting
flutist	fluting
fly	flight
flyer	flight
fold	fold
foldability	fold
follow	follow
follow-up	follow
follower	follow
foment	fomentation
food	feed
fool	fool
footslog	footslog
forbear	forbearance
forecast	forecast
forecaster	forecast
foreclose	foreclosure
forfeit	forfeiture
forge	forging
forgery	forging
forger	forging
forgive	forgiveness
formalize	formalism
formulate	formulation
fornicate	fornication
fortify	fortification
fossilize	fossilization
foul	foul
found	foundation
founder	foundation
founding	foundation
foxhunt	foxhunt
frame	frame
franchise	franchise
franchisee	franchise
fraternize	fraternization
free	freedom
freeing	freedom
freeze	freeze
freezer	freeze
fructify	fructification
frustrate	frustration
fry	fry
fuck	fuck
fuel	fuel
fulfill	fulfilment
fulfillment	fulfilment
fulminate	fulmination
fumble	fumble
fumigate	fumigation
function	function
fund	fund
furnish	furnish
fuse	fusion
fusing	fusion
gain	gain
galvanize	galvanism
gamble	gamble
garden	garden
gasify	gasification
gatecrash	gatecrash
gather	gathering
gatherer	gathering
gauge	gauge
generalize	generalization
generate	generation
generating	generation
generator	generation
genuflect	genuflection
germinate	germination
gerrymander	gerrymander
gesticulate	gesticulation
get	get
get-together	get
give	gift
giveaway	gift
giver	gift
glamorize	glamorization
glean	glean
glide	glide
globalize	globalization
glorify	glorification
glue	glue
go	go
gobble	gobble
golf	golf
govern	government
governance	government
governing	government
governor	government
grab	grab
graduate	graduate
grate	grate
gratify	gratification
gratifying	gratification
gravitate	gravitation
gray	gray
graze	graze
grease	grease
green	green
greet	greeting
greeting	greeting
grieve	grievance
grief	grievance
grind	grind
groove	groove
grovel	grovel
groveler	grovel
grow	growth
grower	growth
growing	growth
growl	growl
grumble	grumble
guarantee	guarantee
guard	guard
guard	guard
guide	guidance
guide	guidance
guideline	guidance
guidepost	guidance
gush	gush
guzzle	guzzle
gyrate	gyration
habituate	habituation
hack	hack
hand	hand
handle	handle
handler	handle
handout	hand
handover	hand
hang	hang
hanger	hang
happen	happening
harass	harassment
harmonize	harmonization
harp	harp
harper	harp
harry	harry
harvest	harvest
harvester	harvest
hate	hatred
haul	haulage
hauler	haulage
hawk	hawk
head	head
head	head
heal	heal
healer	heal
hear	hear
heat	heat
heckle	heckle
hedge	hedge
hedge	hedge
help	help
hemorrhage	hemorrhage
herd	herd
hesitate	hesitation
hesitance	hesitation
hew	hew
hibernate	hibernation
hide	hide
hideaway	hide
hideout	hide
highlight	highlight
hijack	hijack
hike	hike
hiker	hike
hinder	hindrances
hindrance	hindrances
hire	hiring
hit	hit
hitchhike	hitchhike
hoard	hoard
hoax	hoax
hoist	hoist
hold	hold
holder	hold
holdout	hold
honor	honor
hook	hook
hoot	hoot
hop	hop
hospitalize	hospitalization
host	host
howl	howl
humiliate	humiliation
hunt	hunt
hurdle	hurdle
hustle	hustle
hydrogenate	hydrogenation
hype	hype
hypnotist	hypnotism
hypnotize	hypnotism
idealist	idealization
idealize	idealization
idealism	idealization
identify	identity
identification	identity
idle	idle
idler	idle
idolize	idolization
ignite	ignition
ill-treat	ill-treatment
ill-use	ill-usage
illuminate	illumination
illustrate	illustration
illustrator	illustration
imagine	imagination
image	imagination
imitate	imitation
imitator	imitation
immerse	immersion
immigrant	immigration
immigrate	immigration
immobilize	immobilization
immolate	immolation
immunize	immunization
impair	impairment
impale	impalement
impeach	impeachment
impede	impediment
impel	impel
imperil	peril
impersonate	impersonation
impersonator	impersonation
impinge	impingement
implement	implementation
implicate	implication
implode	implosion
import	import
impose	imposition
impoverish	impoverishment
imprecate	imprecation
impress	impression
imprison	imprisonment
improve	improvement
improver	improvement
improving	improvement
improvise	improvisation
improviser	improvisation
impute	imputation
inaugurate	inauguration
incarcerate	incarceration
incarnate	incarnation
incinerate	incineration
incinerator	incineration
incise	incision
incite	incitement
incline	inclination
inclose	inclosure
include	inclusion
incorporate	incorporation
incriminate	incrimination
incubate	incubation
incubator	incubation
incur	incursion
indemnify	indemnity
indemnification	indemnity
indent	indentation
index	index
indexer	index
indicate	indicative
indication	indicative
indicator	indicative
indict	indictment
indoctrinate	indoctrination
induce	induction
inducement	induction
indulge	indulgence
industrialize	industrialization
inebriate	inebriation
infatuate	infatuation
infect	infection
infer	inference
infest	infestation
infiltrate	infiltration
inflame	inflammation
inflate	inflation
inflect	inflection
inflict	infliction
inform	information
informant	information
informer	information
infringe	infringement
infuse	infusion
ingest	ingestion
inhabit	habitation
inhabitant	habitation
inhale	inhalation
inhaler	inhalation
inherit	inheritance
heritage	inheritance
inheritor	inheritance
inhibit	inhibition
inhibitor	inhibition
initiate	initiation
initiator	initiation
inject	injection
injure	injury
innovate	innovation
innovator	innovation
inoculate	inoculation
inquire	inquisition
inquiry	inquisition
inquirer	inquisition
inscribe	inscription
inseminate	insemination
insert	insert
insinuate	insinuation
insist	insistence
inspect	inspection
inspector	inspection
inspire	inspiration
install	installment
installation	installment
instigate	instigation
instigator	instigation
instill	instillation
institute	institution
instruct	instructions
instruction	instructions
instructor	instructions
insulate	insulation
insulator	insulation
insure	insurance
insurer	insurance
integrate	integration
intend	intention
intent	intention
intensifier	intensification
intensify	intensification
inter	interment
interact	interaction
intercede	intercession
intercept	interception
interceptor	interception
intercommunicate	intercommunication
interconnect	interconnection
interdict	interdiction
interfere	interference
interject	interjection
intermarry	intermarriage
intern	intern
internationalize	internationalization
interpellate	interpellation
interpolate	interpolation
interpose	interposition
interpret	interpretation
interpreter	interpretation
interrelate	interrelation
interrogate	interrogation
interrogator	interrogation
interrupt	interruption
interrupter	interruption
intersect	intersection
intervene	intervention
interview	interview
interviewee	interview
intimate	intimation
intimidate	intimidation
intone	intonation
intoxicant	intoxication
intoxicate	intoxication
introduce	introduction
introspect	introspection
introvert	introversion
intrude	intrusion
intruder	intrusion
intuit	intuition
inundate	inundation
invade	invasion
invader	invasion
invalidate	invalidation
invent	invention
inventor	invention
invert	inversion
invest	investment
investigate	investigation
investigator	investigation
investing	investment
investor	investment
invite	invitational
invitation	invitational
invoice	invoice
involve	involvement
involution	involvement
ionize	ionization
irradiate	irradiation
irrigate	irrigation
irritant	irritation
irritate	irritation
isolate	isolation
issue	issuance
issuer	issuance
issuing	issuance
iterate	iteration
jabber	jabber
jail	jail
jailer	jail
jam	jam
jawbone	jawbone
jaywalk	jaywalk
jest	jest
job	job
jockey	jockey
jog	jog
join	join
joint	jointure
joke	jest
joker	jest
jot	jot
juggle	juggle
jump	jump
justify	justification
juxtapose	juxtaposition
keep	keep
kidnap	kidnap
kidnapper	kidnap
kill	kill
killer	kill
kiss	kiss
knit	knit
knock	knock
know	knowledge
know-how	knowledge
known	knowledge
labor	labor
lacerate	laceration
lance	lance
landscape	landscape
launch	launch
launcher	launch
launder	launder
launderer	launder
lay	lay
layer	lay
layoff	lay
lead	lead
leak	leakage
learn	learn
lease	lease
leave	leave
lecture	lecture
legalize	legalization
legislate	legislation
legislator	legislation
lend	lend
lender	lend
lessee	lease
level	level
leveler	level
leveller	level
levitate	levitation
liberalize	liberalization
liberate	liberation
liberator	liberation
license	license
licensee	license
lift	lift
lift-off	lift
liftoff	lift
light	light
lighter	light
like	like
line	line
line-up	line
liner	line
linger	linger
link	link
liquidate	liquidation
liquidator	liquidation
liquidize	liquidize
listen	listen
listener	listen
litigant	litigation
litigate	litigation
live	life
load	load
loaf	loaf
loathe	loathing
lobby	lobby
lobbyist	lobby
localize	localization
locate	location
lock	lock
locker	lock
lodge	lodgement
lodger	lodgement
loiter	loiter
loiterer	loiter
long	longing
look	countenance
looker	countenance
lookout	countenance
loot	loot
looter	loot
lord	lord
lose	loss
loser	loss
lounge	lounge
love	love
lubricant	lubrication
lubricate	lubrication
lurch	lurch
luxuriate	luxuriance
machinate	machination
magnetize	magnetization
magnifier	magnification
magnify	magnification
maintain	maintenance
maintainence	maintenance
make	make
maker	make
makeup	makeup
malinger	malinger
maltreat	maltreatment
manage	management
manager	management
managing	management
maneuver	maneuver
manicure	manicure
manifest	manifestation
manipulate	manipulation
manipulator	manipulation
manufacture	manufacture
manufacturer	manufacture
manumit	manumission
manure	manure
map	map
maraud	maraud
march	march
margin	margin
mark	mark
mark	mark
markdown	mark
market	market
marketability	market
marketer	market
marry	marriage
mash	mash
master	master
mastermind	mastermind
mastermind	mastermind
masticate	mastication
masturbate	masturbation
match	match
match	match
materialize	materialization
matriculate	matriculation
matter	matter
mature	maturity
maturation	maturity
maximize	maximization
mean	mean
mechanize	mechanization
meddle	meddle
mediate	mediation
mediator	mediation
medicate	medication
meditate	meditation
meet	meet
meld	meld
meliorate	melioration
melt	meltdown
melting	meltdown
mend	mend
menstruate	menstruation
mentor	mentor
merge	merger
merging	merger
mesmerist	mesmerism
mesmerize	mesmerism
migrant	migration
migrate	migration
mill	mill
mimic	mimicry
mince	mince
mind	mind
mine	mine
miner	mine
miniaturize	miniaturization
mirror	mirror
mirror	mirror
misapply	misapplication
misapprehend	misapprehension
misappropriate	misappropriation
misbehave	misbehavior
miscalculate	miscalculation
miscarry	miscarriage
misconceive	misconception
misdirect	misdirection
misgovern	misgovernment
mishandle	mishandle
misinform	misinformation
misinterpret	misinterpretation
misjudge	misjudgment
mismanage	mismanagement
misquote	misquotation
misrepresent	misrepresentation
misstate	misstatement
mistranslate	mistranslation
misunderstand	misunderstanding
mitigate	mitigation
mix	mix
mobilize	mobilization
mock	mockery
mocker	mockery
model	model
modeler	model
modeller	model
moderate	moderate
modernize	modernization
modifier	modification
modify	modification
modulate	modulation
moisturize	moisturize
molest	molestation
mollify	mollification
monetize	monetization
monitor	monitor
monitor	monitor
monopolist	monopoly
monopolize	monopoly
monopolization	monopoly
moonlight	moonlight
mop	mop
mortgage	mortgage
mortgagee	mortgage
mortify	mortification
mothball	mothball
motion	motion2
motivate	motivation
mourn	mourn
mouse	mouse
move	motion1
mover	motion1
mow	mow
muffle	muffle
mug	mug
mulch	mulch
multiplier	multiplication
multiply	multiplication
multiple	multiplication
mummify	mummification
murder	murder
mutate	mutation
mutilate	mutilation
mutter	mutter
mystify	mystification
nag	nag
nagger	nag
name	name
narrate	narration
narrator	narration
narrow	narrow
nationalize	nationalization
naturalize	naturalization
navigate	navigation
navigator	navigation
need	necessity
negate	negation
negotiate	negotiation
negotiating	negotiation
negotiator	negotiation
neighbor	neighbor
network	network
neutralize	neutralization
nickname	nickname
nip	nip
nominate	nomination
nominee	nomination
normalize	normalization
notify	notification
nourish	nourishment
nullify	nullification
nurse	nurse
obey	obeisance
obedience	obeisance
obfuscate	obfuscation
object	object
oblige	obligation
obliterate	obliteration
observe	observation
observance	observation
observer	observation
observing	observation
obsess	obsession
obstruct	obstruction
obstructionism	obstruction
occupant	occupation
occupier	occupation
occupy	occupation
occupancy	occupation
occur	occurrence
offend	offense
offender	offense
offer	offer
oil	oil
omit	omission
open	open
opener	open
opening	open
operate	operation
operating	operation
operator	operation
opine	opinion
opponent	opposition
oppose	opposition
oppress	oppression
oppressor	oppression
opt	option
optimize	optimization
orate	oratory
oration	oratory
orator	oratory
orchestrate	orchestration
organize	organization
organizer	organization
organizing	organization
orientate	orientation
originate	origination
origin	origination
originator	origination
ornament	ornament
oscillate	oscillation
oscillator	oscillation
ossify	ossification
ostracize	ostracism
oust	ouster
outbreak	break
outfit	outfit
outlaw	outlawry
outlay	lay
outride	outride
outset	set
overbuild	overbuild
overexert	overexertion
overexpose	overexposure
overextend	overextension
overindulge	overindulgence
overpay	overpayment
overproduce	overproduction
oversee	oversight
overseer	oversight
overspend	overspend
overstate	overstatement
own	ownership
owner	ownership
oxidize	oxidization
oxidation	oxidization
pace	pace
pacify	pacification
pack	pack
package	package
paint	paint
palliate	palliation
palm	palm
palpitate	palpitation
parachute	parachute
paralyze	paralysis
pardon	pardon
park	parking
parody	parody
parole	parole
participant	participation
participate	participation
party	participation
pasteurize	pasteurization
patent	patent
patrol	patrol
patronize	patronize
pauperize	pauperization
pave	pave
pay	pay
payee	pay
payer	pay
peck	peck
peculate	peculation
peddle	peddle
peel	peel
peep	peep
penalize	penalization
penetrate	penetration
pension off	pension
pensioner	pension
perambulate	perambulation
perambulator	perambulation
perceive	perception
perceiver	perception
perceptiveness	perception
percolate	percolate
perfect	perfection
perfecting	perfection
perforate	perforation
perform	performance
performer	performance
perfume	perfume
perjure	perjury
perjurer	perjury
permeate	permeation
permit	permission
permit	permission
permute	permutation
perpetrate	perpetration
perpetrator	perpetration
perpetuate	perpetuation
persecute	persecution
persecutor	persecution
persevere	perseverance
persist	persistence
personate	personation
personify	personification
perspire	perspiration
persuade	persuasion
perturb	perturbation
peruse	perusal
pervade	pervasion
pervert	perversion
petition	petition
phase	phase
philander	philander
photocopy	photocopy
photograph	photograph
phrase	phrase
pick	pick
pick	pick
picker	pick
pile	pile
pilfer	pilferage
pilferer	pilferage
pillage	pillage
pin	pin
pioneer	pioneer
pipe	pipe
pirate	piracy
pirate	piracy
pitch	pitch
place	place
plagiarist	plagiarism
plagiarize	plagiarism
plan	plan
planner	plan
plant	plant
plantation	plant
planter	plant
plaster	plaster
play	play
player	play
please	pleasure
plod	plod
plot	plot
plunder	plunder
plunge	plunge
plunger	plunge
poach	poach
point	point
poison	poison
poke	poke
polarize	polarization
polish	polish
polisher	polish
poll	poll
pollinate	pollination
pollutant	pollution
pollute	pollution
popularize	popularization
populate	population
port	port
portend	portend
portray	portrayal
pose	pose
position	position
possess	possession
possessor	possession
post	post
postpone	postponement
potter	potter
pound	pound
practice	practice
practitioner	practice
prattle	prattle
pray	prayer
pre-empt	pre-emption
pre-exist	pre-existence
preach	preach
prearrange	prearrangement
precede	precession
precedence	precession
precedent	precession
precipitate	precipitation
preclude	preclusion
predecessor	precession
predestinate	predestination
predetermine	predetermination
predict	prediction
predictor	prediction
predispose	predisposition
predominate	predominance
prefabricate	prefabrication
prefer	preferment
preference	preferment
prejudge	prejudgement
premeditate	premeditation
preoccupy	preoccupation
prepare	preparation
preparer	preparation
prepay	prepayment
preponderate	preponderance
prepossess	prepossession
prescribe	prescription
present	present
presenter	present
preserve	preservation
preserver	preservation
press	pressure
pressure	pressure
presume	presumption
presuppose	presupposition
pretend	pretension
pretense	pretension
pretender	pretension
prevail	prevalance
prevaricate	prevarication
prevent	prevention
prey	prey
price	price
prick	prick
prime	prime
print	print
printer	print
privatize	privatization
probate	probation
proceed	proceeding
process	process
processor	process
proclaim	proclamation
procrastinate	procrastination
procreate	procreation
procure	procurement
procurer	procurement
prod	prod
produce	production
product	production
producer	production
profane	profanation
profess	profession
professor	profession
profit	profit
prognosticate	prognostication
program	program
programme	programme
prohibit	prohibition
project	project
proliferate	proliferation
prolong	prolongation
promote	promotion
promoter	promotion
prompt	prompt
promulgate	promulgation
pronounce	pronunciation
pronouncement	pronunciation
proofread	proofread
propagandize	propagandize
propagate	propagation
propagator	propagation
propel	propellant
propellent	propellant
propeller	propellant
propitiate	propitiation
propose	proposition
proposal	proposition
proposer	proposition
proposing	proposition
prorogue	prorogation
proscribe	proscription
prosecute	prosecution
prosecutor	prosecution
prospect	prospect
prospector	prospect
prosper	prosperity
prostitute	prostitution
prostrate	prostration
protect	protectionism
protection	protectionism
protector	protectionism
protest	protest
protract	protraction
protractor	protraction
protrude	protrusion
prove	proof
provide	provision
provider	provision
provoke	provocation
prowl	prowl
psychoanalyze	psychoanalyze
publicize	publicize
publish	publication
publisher	publication
publishing	publication
puddle	puddle
pull	pull
pull-out	pull
pullback	pull
pulsate	pulsation
pummel	pummel
pump	pump
punch	punch
punctuate	punctuation
punish	punishment
punt	punt
purchase	purchase
purchaser	purchase
purge	purgation
purifier	purification
purify	purification
pursue	pursuit
pursuance	pursuit
pursuer	pursuit
pursuing	pursuit
purvey	purveyance
purveyor	purveyance
push	push
put	put
putter	putter
puzzle	puzzlement
puzzler	puzzlement
quadruple	quadruple
qualifier	qualification
qualify	qualification
qualifying	qualification
quantify	quantification
question	question
quibble	quibble
quit	quit
quote	quotation
race	race
radiate	radiation
radiance	radiation
radiator	radiation
radiopasteurize	radiopasteurization
raft	raft
raid	raid
rail	raillery
raise	raise
raiser	raise
ramble	ramble
ramify	ramification
ranch	ranch
rank	rank
ranker	rank
rant	rant
rape	rape
rate	rate
ratify	ratification
rationalize	rationalization
rattle	rattle
rattle	rattle
rave	rave
ravish	ravishment
raze	raze
re-elect	re-election
re-enact	re-enactment
re-enter	re-entry
re-form	re-formation
reach	reach
react	reaction
reactor	reaction
read	read
reader	read
readjust	readjustment
readmit	readmission
realign	realignment
realize	realization
reap	reap
reappear	reappearance
reappraise	reappraisal
rear	rear
rearm	rearmament
rearrange	rearrangement
reassess	reassessment
reassign	reassignment
reassure	reassurance
reauthorize	reauthorization
rebel	rebellion
rebut	rebuttal
recalculate	recalculation
recant	recantation
recapitalize	recapitalization
recapitulate	recapitulation
receivable	reception
receive	reception
receipt	reception
receiver	reception
receptor	reception
recess	recession
recipient	reception
reciprocate	reciprocation
recite	recitation
recital	recitation
reckon	reckoning
reckoner	reckoning
recognize	recognizance
recognition	recognizance
recollect	recollection
recombine	recombination
recommend	recommendation
reconcile	reconciliation
reconnoiter	reconnaissance
reconsider	reconsideration
reconstruct	reconstruction
record	record
recover	recovery
recreate	recreation
recriminate	recrimination
recruit	recruit
recruit	recruit
recruiter	recruit
rectifier	rectification
rectify	rectification
recuperate	recuperation
recur	recurrence
recycle	recycle
redact	redaction
redeem	redemption
redeemer	redemption
redefine	redefinition
redeploy	redeployment
redevelop	redevelopment
rediscover	rediscovery
redistribute	redistributionism
redistribution	redistributionism
reduce	reduction
reduplicate	reduplication
reef	reef
reevaluate	reevaluation
refer	referral
reference	referral
referee	referee
referee2	referral
refinance	refinance
refine	refinement
refiner	refinement
refinery	refinement
refining	refinement
reflate	reflation
reflect	reflection
reflector	reflection
refocus	refocus
reforest	reforestation
reform	reform
reformer	reform
reformulate	reformulation
refract	refraction
refresh	refreshment
refresher	refreshment
refrigerate	refrigeration
refrigerator	refrigeration
refund	refund
refurbish	refurbishment
refurbishing	refurbishment
refuse	refusal
refuse	refusal
refute	refutation
regenerate	regeneration
regiment	regimentation
regress	regression
regularize	regularization
regulate	regulation
regulator	regulation
rehabilitate	rehabilitation
rehear	rehear
rehearse	rehearsal
reimburse	reimbursement
reincarnate	reincarnation
reinforce	reinforcement
reinstate	reinstatement
reinsure	reinsurance
reinsurer	reinsurance
reinterpret	reinterpretation
reinvest	reinvestment
reiterate	reiteration
reject	rejection
rejuvenate	rejuvenation
relate	relationship
relation	relationship
relax	relaxation
relegate	relegation
relieve	relief
relinquish	relinquishment
relocate	relocation
rely	reliance
remain	remain
remarket	remarket
remarry	remarriage
remember	remembrance
remilitarize	remilitarization
remind	remind
reminisce	reminiscence
remit	remittance
remission	remittance
remodel	remodel
remonstrate	remonstrance
remove	removal
remover	removal
remunerate	remuneration
render	rendering
renegotiate	renegotiation
renew	renewal
renounce	renunciation
renovate	renovation
renovator	renovation
rent	rent
reopen	reopen
reorder	reorder
reorganize	reorganization
reorientate	reorientation
repair	repair
repatriate	repatriation
repay	repayment
repeat	repeat
repel	repulsion
repellent	repulsion
repent	repentance
replace	replacement
replenish	replenishment
report	report
reporter	report
reposition	reposition
represent	representation
representative	representation
repress	repression
reprobate	reprobation
reproduce	reproduction
reproducer	reproduction
reprove	reproval
repudiate	repudiation
repute	reputation
rep	reputation
require	requirement
requite	requital
rescind	rescission
rescue	rescue
research	research
researcher	research
resemble	resemblance
resent	resentment
reserve	reservation
resettle	resettlement
reshuffle	reshuffle
reside	residence
resident	residence
resign	resignation
resist	resistance
resister	resistance
resistor	resistance
resolve	resolution
resonate	resonance
resonator	resonance
respect	respect
respire	respiration
respond	response
respondent	response
restart	restart
restate	restatement
restitute	restitution
restore	restoration
restorer	restoration
restrain	restraint
restrict	restriction
restructure	restructure
resume	resumption
resurrect	resurrection
resuscitate	resuscitation
retail	retail
retailer	retail
retain	retention
retainer	retention
retaliate	retaliation
retard	retardation
retardant	retardation
reticulate	reticulation
retire	retirement
retiree	retirement
retract	retraction
retread	retread
retrench	retrenchment
retrieve	retrieval
retriever	retrieval
retrogress	retrogression
reunify	reunification
reunite	reunion
revaluate	revaluation
revamp	revamp
reveal	revelation
revel	revel
reveler	revel
reverberate	reverberation
revere	reverence
reverse	table
reversion	table
reversal	table
review	review
revise	revision
reviser	revision
revitalize	revitalization
revive	revival
revolt	revolution
rid	riddance
ride	ride
rider	ride
rig	rig
ring	ring
riot	riot
rise	rise
riser	rise
rival	rival
rivet	rivet
roast	roast
rob	robbery
robber	robbery
rock	rock
roll	roll
roll-out	roll
roller	roll
romp	romp
room	room
root	root
rot	rot
rotate	rotation
rout	rout
rove	rove
row	row
rub	rub
ruin	ruination
rule	rule
rumble	rumble
ruminant	rumination
ruminate	rumination
run	run
run-up	run
runaway	run
rustle	rustle
saddle	saddle
sail	sailing
sailor	sailing
salesman	sale
salute	salutation
salve	salve
sanctify	sanctification
sap	sap
satirize	satirize
satisfy	satisfaction
saturate	saturation
saunter	saunter
savage	savagery
save	salvation
saver	salvation
saving	salvation
savior	salvation
scale	scale
scan	scan
scavenge	scavenge
schedule	schedule
scheme	scheme
scintillate	scintillation
scoff	scoff
scorch	scorch
score	score
scour	scour
scourge	scourge
scout	scout
scramble	scramble
scrap	scrap
scrape	scrape
screen	screen
scribble	scribble
scrounge	scrounge
scrutinize	scrutiny
scull	scull
sculpt	sculpture
sculptor	sculpture
seal	seal
search	search
seat	seat
secede	secession
seclude	seclusion
second	second
secrete	secretion
secure	security
sedate	sedation
seduce	seduction
seducer	seduction
see	see
seek	seek
segregate	segregation
seize	seizure
select	selection
selector	selection
sell	sale
sell-off	sale
seller	sale
selling	sale
send	send
sense	sensation
sensitize	sensitization
sensor	sensation
sentence	sentence
sentimentalize	sentimentalize
separate	separation
separator	separation
sequestrate	sequestration
servant	service
serve	service
server	service
service	service
serving	service
set	set
setback	set
setter	set
settle	settlement
settler	settlement
settling	settlement
setup	set
sever	severance
shake	shake
shake-up	shake
shakeout	shake
share	share
sharpen	sharpen
shave	shave
shed	shed
shelter	shelter
ship	shipment
shipper	shipment
shipping	shipment
shirk	shirk
shock	shock
shoot	shoot
shooter	shoot
shop	shopping
shoplift	shoplift
shopper	shopping
shout	shouting
show	show
shrink	shrinkage
shuffle	shuffle
shunt	shunt
shut	shut
shutdown	shut
sift	sift
sign	sign
signal	signal
significance	signification
signify	signification
signor	sign
silence	silence
simplify	simplification
simulate	simulation
simulator	simulation
sin	sin
sing	sing
sink	sinking
sinker	sinking
sit	sit
sitter	sit
situate	situation
skate	skate
sketch	sketch
skew	skew
ski	ski
skim	skim
skip	skip
skipper	skipper
skirmish	skirmish
skulk	skulk
slack	slack
slander	slander
slap	slap
slash	slash
slaughter	slaughter
slaver	slavery
slay	slay
slayer	slay
sleep	sleep
slice	slice
sling	sling
slog	slog
slow	slow
slowdown	slow
slumber	slumber
smash	smash
smelt	smelt
smelter	smelt
smoke	smoke
smoker	smoke
smuggle	smuggle
snag	snag
snake	snake
snatch	snatch
snipe	snipe
snivel	snivel
sniveler	snivel
snoop	snoop
snore	snore
snort	snort
soak	soak
socialize	socialization
soften	soften
softener	soften
sojourn	sojourn
solemnize	solemnization
solicit	solicitation
solicitor	solicitation
solidify	solidification
solo	solo
solve	solution
solvent	dissolution
sort	sort
sour	sour
sow	sow
span	span
spank	spanking
sparkle	sparkle
spatter	spatter
speak	speech
speaker	speech
spearhead	spearhead
specialist	specialty
specialize	specialty
specialization	specialty
specialism	specialty
specify	specification
speculate	speculation
speculating	speculation
speculator	speculation
speed	speed
speedup	speed
spell	spell
speller	spell
spend	expenditure
spender	expenditure
spending	expenditure
spin	spin
spin-dry	spin-dry
spin-off	spin
spinner	spin
spinoff	spin
spinout	spin
spiritualize	spiritualization
splice	splice
sponge off	sponge off
sponsor	sponsor
spot	spot
spray	spray
spread	spread
spring	spring
sprinkle	sprinkle
sprint	sprint
spy	espionage
spy	espionage
squabble	squabble
squat	squat
squawk	squawk
squeak	squeak
squeal	squeal
squeeze	squeeze
stab	stab
stabilize	stabilization
stabilizer	stabilization
staff	staff
stage	stage
stager	stage
stagger	stagger
stagnate	stagnation
stalk	stalk
stammer	stammer
stand	stand
standardize	standardization
staple	staple
star	star
start	start
start-up	start
starve	starvation
stay	stay
steam	steam
steer	steerage
steering	steerage
sterilize	sterilization
stick	stick
stiffen	stiffen
stimulant	stimulation
stimulate	stimulation
stimulator	stimulation
sting	sting
stink	stink
stipulate	stipulation
stir	stir
stock	stock
stockist	stock
stoke	stoke
stonewall	stonewall
stop	stop
store	storage
straggle	straggle
strain	strain
strategize	strategize
stratify	stratification
streamline	streamline
strengthen	strengthen
stress	stress
stretch	stretch
stridulate	stridulation
strike	strike
strip	strip
strive	strive
stroll	stroll
structure	structure
study	study
stultify	stultification
stump	stump
stun	stun
stutter	stutter
stylist	stylization
stylize	stylization
subcontract	subcontract
subdivide	subdivision
subedit	subedit
subjugate	subjugation
sublimate	sublimation
submerge	submergence
submit	submission
subordinate	subordinate
suborn	subornation
subscribe	subscription
subscriber	subscription
subside	subsidence
subsidize	subsidy
subsidization	subsidy
subsist	subsistence
substantiate	substantiation
substitute	substitute
subtract	subtraction
subvert	subversion
succeed	succession
success	succession
successor	succession
suck	suck
sue	suit
lawsuit	suit
suffer	sufferance
sufferer	sufferance
suffering	sufferance
suffocate	suffocation
suffuse	suffusion
suggest	suggestion
suit	suit
summarize	summary
sup	sup
superannuate	superannuation
superintend	superintendence
superintendent	superintendence
supersede	supersession
supervise	supervision
supervisor	supervision
supplant	supplant
suppliant	supplication
supplicant	supplication
supplicate	supplication
supply	supply
support	support
suppose	supposition
suppress	suppression
suppressant	suppression
suppressor	suppression
suppurate	suppuration
surround	surround
survey	surveillance
surveyor	surveillance
survive	survival
survivor	survival
suspect	suspect
suspend	suspension
suspense	suspension
suspender	suspension
sustain	sustenance
sustainability	sustenance
swagger	swagger
swap	swap
sway	sway
swear	swearing
swearer	swearing
swearing-in	swearing
sweat	sweat
sweep	sweep
sweeten	sweeten
sweetener	sweeten
swim	swim
swindle	swindle
switch	switch
syllabicate	syllabication
syllabify	syllabification
symbolize	symbolization
symbolism	symbolization
symbol	symbolization
sympathize	sympathy
sympathizer	sympathy
synchronize	synchronization
sync	synchronization
syncopate	syncopation
syndicate	syndicate
synthesize	synthesis
synthesizer	synthesis
systematize	systematization
tabulate	tabulation
tabulator	tabulation
tailor	tailor
take	take
take-off	take
take-out	take
takeoff	take
takeout	take
takeover	take
taker	take
talk	talk
tame	tame
tan	tan
tape	tape
taper	tape
taste	taste
tattle	tattle
taunt	taunt
teach	teach
teacher	teach
tease	teasing
teaser	teasing
telegraph	telegraph
telegrapher	telegraph
televise	televise
temper	temperance
tempt	temptation
tempter	temptation
tend	tendency
tender	tendency
tense	tension
terminate	termination
terrorist	terrorism
terrorize	terrorism
test	test
testify	testimony
testimonial	testimony
testament	testimony
thatch	thatch
theorize	theorize
thief	thievery
thieve	thievery
theft	thievery
think	thought
thinking	thought
thinker	thought
threaten	threat
thrill	thrill
throb	throbbing
throw	throw
thrust	thrust
tick	tick
tickle	tickle
tie	tie
tighten	tighten
tightener	tighten
till	tilth
tiller	tilth
time	time
timer	time
tinker	tinker
tip	tip
tip-off	tip
tipper	tip
tipple	tipple
titillate	titillation
toast	toast
toil	toil
toiler	toil
tolerate	toleration
tolerance	toleration
tone	tone
tool	tool
top	top
torment	torment
torture	torture
toss	toss
tour	tour
trace	trace
track	track
tracker	track
trade	trade
trade-in	trade
trader	trade
traduce	traduce
traffic	traffic
trail	trail
train	train
trainee	train
trainer	train
tranquillize	tranquillize
transact	transaction
transcend	transcendence
transcribe	transcription
transcript	transcription
transfer	transfer
transfigure	transfiguration
transform	transformation
transformer	transformation
transfuse	transfusion
transgress	transgression
transgressor	transgression
translate	translation
translator	translation
transliterate	transliteration
transmit	transmission
transmitter	transmission
transmogrify	transmogrification
transmute	transmutation
transpire	transpiration
transport	transport
transpose	transposition
trap	trap
trap	trap
trapper	trap
traumatize	trauma
travel	travel
traveler	travel
traveller	travel
treat	treatment
trench	trench
trespass	trespass
trier	trial
trifle	trifle
trigger	trigger
trigger	trigger
trim	trim
trip	trip
trot	trot
trumpet	trumpet
try	trial
tryout	trial
tuck	tuck
tumble	tumble
tune	tune
tuner	tune
turn	turn
turn-on	turn
turnaround	turn
twist	twist
type	type
ulcerate	ulceration
ululate	ululation
uncover	uncover
underestimate	underestimation
underexpose	underexposure
underpay	underpayment
underpin	underpin
understand	understand
understate	understatement
undertake	undertake
undertaker	undertake
undervalue	undervaluation
underwrite	underwrite
underwriter	underwrite
undo	undo
undulate	undulation
unifier	unification
unify	unification
unite	unity
unload	unload
unravel	unravel
unsettle	unsettlement
unveil	unveil
update	update
upgrade	upgrade
upholster	upholster
urbanize	urbanization
usability	usage
use	usage
user	usage
usurp	usurpation
usurper	usurpation
utilize	utilization
utter	utterance
vacation	vacation
vacationer	vacation
vaccinate	vaccination
vacillate	vacillation
value	valuation
valuer	valuation
vaporize	vaporization
variable	variety
variant	variety
vary	variety
variation	variety
variance	variety
vault	vault
vaunt	vaunt
vegetate	vegetation
vend	vend
vendee	vend
vender	vend
venerate	veneration
ventilate	ventilation
ventilator	ventilation
verify	verification
vest	vestment
vex	vexation
vibrate	vibration
vibrator	vibration
victimize	victimization
view	view
vilify	vilification
vindicate	vindication
violate	violation
violator	violation
visit	visit
visitant	visit
visitor	visit
visualize	visualization
vituperate	vituperation
vivisect	vivisection
vociferate	vociferation
volunteer	volunteer
vote	vote
voter	vote
vouch	vouch
voyage	voyage
vulcanize	vulcanization
vulgarize	vulgarization
wade	wade
wait	wait
waive	waiver
walk	walk
walker	walk
wander	wander
warble	warble
ward	ward
warm	warm
warm-up	warm
warmer	warm
warn	warning
warrant	warrant
warrantee	warrant
wash	wash
waste	wastage
waster	wastage
wasting	wastage
watch	watch
waver	waver
weaken	weaken
wear	wear
weave	weave
weaver	weave
wed	wedding
weight	weight
weld	weld
welsh	welsh
westernize	westernization
whack	whack
whale	whale
whine	whine
whip	whipping
whisk	whisk
whisper	whisper
whore	whore
widen	widen
win	win
wipe	wipe
wish	wish
withdraw	withdrawal
witness	witness
wobble	wobble
womanize	womanize
woo	woo
wooer	woo
work	work
worker	work
worsen	worsen
worship	worship
wrangle	wrangle
wrap	wrap
wreck	wreck
wrestle	wrestle
wriggle	wriggle
wring	wring
write	write
write-down	write
write-off	write
writedown	write
writer	write
yearn	yearning
yodel	yodel
yodeler	yodel
